(attribute 		is_kind_of 		top)
(stuff  		is_kind_of  	top)
(aka 			is_kind_of 		attribute)

#
(person 		is_kind_of 		stuff)
(item 			is_kind_of 		stuff)
(place 			is_kind_of 		stuff)
(relpos 			is_kind_of 		stuff)
(relpath 			is_kind_of 		stuff)

# personas y robot
(robot 	 		is_kind_of 		person)
(man 			is_kind_of 		person)
(woman	 		is_kind_of 		person)
(john			is_kind_of		person)
(michael		is_kind_of		person)
(me  			is_kind_of			person)
(i				is_kind_of			person)
(you			is_kind_of			person)
(he 			is_kind_of			person)
(she			is_kind_of			person)
(sister         is_kind_of	person)
(guest          is_kind_of	person)
(mother         is_kind_of	person)
(friend         is_kind_of	person)
(father         is_kind_of	person)
#it
(we		is_kind_of	person)
(them   	is_kind_of	person)
(they   	is_kind_of	person)
(us     	is_kind_of	person)
#(my     	is_kind_of	person)
(your   	is_kind_of	person)

# lugares
(room 			is_kind_of  	place)
(there 			is_kind_of 		place)
(here 			is_kind_of 		place)
(tables         	is_kind_of	place)
(stands         	is_kind_of	place)
(sinks          	is_kind_of	place)
(drawers        	is_kind_of	place)
(chairs         	is_kind_of	place)
(fences         	is_kind_of	place)
(taps           	is_kind_of	place)
(couches        	is_kind_of	place)
(bedroom 	 	is_kind_of 		place)
(garden 		is_kind_of 		place)
(kitchen 		is_kind_of 		place)
(hallway 		is_kind_of 		place)
(lounge 		is_kind_of  	place)
(bathroom	 	is_kind_of 		place)
(dresser 		is_kind_of 		place)
(dining_room 	is_kind_of 		place)
(patio	is_kind_of 		place)
(chair 			is_kind_of 		place)
(bin	 	 	is_kind_of 		place)
(bed 	 		is_kind_of 		place)
(bathroom_locker 	is_kind_of 		place)
(shelf	 		is_kind_of  	place)
(diner_table	is_kind_of 		place)
(hall	 		is_kind_of 		place)
(kitchen_table 	is_kind_of 		place)
(corridor	 	is_kind_of 		place)
(living_room	 	is_kind_of 		place)
(wall	 	is_kind_of 		place)
#sinonimos con places
(nightstand     is_kind_of	place)
(diningroom     is_kind_of	place)
(bedroom        is_kind_of	place)
(set            is_kind_of	place)
(table          is_kind_of	place)
(dining         is_kind_of	place)
(bath           is_kind_of	place)
(bathroom       is_kind_of	place)
(bath-tub       is_kind_of	place)
(tub            is_kind_of	place)
(room           is_kind_of	place)
(tv             is_kind_of	place)
(television     is_kind_of	place)
(washing        is_kind_of	place)
(machine        is_kind_of	place)
(refrigerator   is_kind_of	place)
(kitchen        is_kind_of	place)
(door           is_kind_of	place)
(couch          is_kind_of	place)
(stereo         is_kind_of	place)
(guy            is_kind_of	place)
(living         is_kind_of	place)
(furniture      is_kind_of	place)
(sink           is_kind_of	place)
(house          is_kind_of	place)
(bin            is_kind_of	place)
(boiler         is_kind_of	place)
(bed            is_kind_of	place)
(fridge         is_kind_of	place)
(bedside        is_kind_of	place)
(stand          is_kind_of	place)
(shower         is_kind_of	place)
(counter        is_kind_of	place)
(sofa           is_kind_of	place)
(line           is_kind_of	place)
(stove          is_kind_of	place)
(pantry         is_kind_of	place)
(oven           is_kind_of	place)
(studio         is_kind_of	place)
(wall           is_kind_of	place)
(mirror         is_kind_of	place)
(desktop        is_kind_of	place)
(laundry        is_kind_of	place)
(person         is_kind_of	place)
(closet         is_kind_of	place)
(bookshelf      is_kind_of	place)
(postman        is_kind_of	place)
(man            is_kind_of	place)
(drawer         is_kind_of	place)
(bathtub        is_kind_of	place)
(hall           is_kind_of	place)
(garden         is_kind_of	place)
(corridor       is_kind_of	place)
(bedstand       is_kind_of	place)
(storage        is_kind_of	place)
(cupboard       is_kind_of	place)
(livingroom     is_kind_of	place)
(deck           is_kind_of	place)
(dishwasher     is_kind_of	place)
(dresser        is_kind_of	place)
(washer         is_kind_of	place)
(tablecloth     is_kind_of	place)
(night          is_kind_of	place)
(butcher        is_kind_of	place)
(pc             is_kind_of	place)
(look           is_kind_of	place)
(lounge         is_kind_of	place)
(seat           is_kind_of	place)
(desk           is_kind_of	place)
(lanyard        is_kind_of	place)
(wardrobe       is_kind_of	place)
(loo            is_kind_of	place)

#posiciones relativas
(right_of	is_kind_of	relpos)
(right	is_kind_of	relpos)
(near_of	is_kind_of	relpos)
(near	is_kind_of	relpos)
(left_of	is_kind_of	relpos)
(left	is_kind_of	relpos)
(in_front_of	is_kind_of	relpos)
(in_front	is_kind_of	relpos)
(front          is_kind_of	relpos)
(behind_of	is_kind_of	relpos)
(behind	is_kind_of	relpos)
(next_to	is_kind_of	relpos)
(center	is_kind_of	relpos)
(center_of	is_kind_of	relpos)
(border	is_kind_of	relpos)
(side           is_kind_of	relpos)
(head           is_kind_of	relpos)
(corner         is_kind_of	relpos)
(end            is_kind_of	relpos)
(at_corner         is_kind_of	relpos)
(at_corner_of         is_kind_of	relpos)
(at_end            is_kind_of	relpos)
(at_end_of            is_kind_of	relpos)
(closely		is_kind_of	relpos)
(close  		is_kind_of	relpos)
(away	is_kind_of	relpos)
(down	is_kind_of relpos)
(there	is_kind_of relpos)
(over	is_kind_of relpos)
(out	is_kind_of	relpos)
(up 	is_kind_of	relpos)

#trayectorias relativas
(along	is_kind_of	relpath)
(around	is_kind_of	relpath)
(follow	is_kind_of	relpath)
(following	is_kind_of	relpath)
(next_to	is_kind_of	relpath)
(towards	is_kind_of	relpath)
(straight	is_kind_of	relpath)

# comida
(beverage 			is_kind_of 		item)
#objetos varios
(cereals		is_kind_of	item)  
(messages       	is_kind_of	item)
(clothes        	is_kind_of	item)
(shoes          	is_kind_of	item)
(cups           	is_kind_of	item)
(blinds         	is_kind_of	item)
(pillows        	is_kind_of	item)
(clops          	is_kind_of	item)
(slippers       	is_kind_of	item)
(pictures       	is_kind_of	item)
(pants          	is_kind_of	item)
(keys           	is_kind_of	item)
(napkins        	is_kind_of	item)
(lamps          	is_kind_of	item)
(bags           	is_kind_of	item)
(thanks         	is_kind_of	item)
(mugs           	is_kind_of	item)
(scissors       	is_kind_of	item)
(glasses        	is_kind_of	item)
(horn_glasses        	is_kind_of	item)
(sunglasses     	is_kind_of	item)
(flowers        	is_kind_of	item)
(cans           	is_kind_of	item)
(plates         	is_kind_of	item)
(shutters       	is_kind_of	item)
(forks          	is_kind_of	item)
(cigarettes     	is_kind_of	item)
(beers          	is_kind_of	item)
(lights         	is_kind_of	item)
(cornflakes     	is_kind_of	item)
(trousers       	is_kind_of	item)
(curtains       	is_kind_of	item)
(utensils       	is_kind_of	item)
(milk		is_kind_of	item)
(towels         is_kind_of	item)
(telephone      is_kind_of	item)
(magazine       is_kind_of	item)
(robot          is_kind_of	item)
(phone          is_kind_of	item)
(vase           is_kind_of	item)
(glass          is_kind_of	item)
(water          is_kind_of	item)
(mug            is_kind_of	item)
(cutlery        is_kind_of	item)
(pace           is_kind_of	item)
(laptop         is_kind_of	item)
(check          is_kind_of	item)
(hoodie         is_kind_of	item)
(jacket         is_kind_of	item)
(hook           is_kind_of	item)
(towel          is_kind_of	item)
(newspaper      is_kind_of	item)
(coffee         is_kind_of	item)
(wristwatch     is_kind_of	item)
(coke           is_kind_of	item)
(aspirin        is_kind_of	item)
(control        is_kind_of	item)
(tray           is_kind_of	item)
(cabinet        is_kind_of	item)
(toilet         is_kind_of	item)
(paper          is_kind_of	item)
(folder         is_kind_of	item)
(cereal         is_kind_of	item)
(box            is_kind_of	item)
(way            is_kind_of	item)
(bottle         is_kind_of	item)
(trash          is_kind_of	item)
(eyeglass       is_kind_of	item)
(lamp           is_kind_of	item)
(book           is_kind_of	item)
(cover          is_kind_of	item)
(cushion        is_kind_of	item)
(catalogue      is_kind_of	item)
(postcard       is_kind_of	item)
(heating        is_kind_of	item)
(pan            is_kind_of	item)
(fork           is_kind_of	item)
(press          is_kind_of	item)
(chair          is_kind_of	item)
(hat            is_kind_of	item)
(jour           is_kind_of	item)
(garbage        is_kind_of	item)
(wallet         is_kind_of	item)
(shampoo        is_kind_of	item)
(pillow         is_kind_of	item)
(watch          is_kind_of	item)
(envelope       is_kind_of	item)
(hair           is_kind_of	item)
(pile           is_kind_of	item)
(coat           is_kind_of	item)
(paperback      is_kind_of	item)
(tablet         is_kind_of	item)
(jar            is_kind_of	item)
(cake           is_kind_of	item)
(plate          is_kind_of	item)
(poster         is_kind_of	item)
(tap            is_kind_of	item)
(radio          is_kind_of	item)
(cup            is_kind_of	item)
(lot            is_kind_of	item)
(rag            is_kind_of	item)
(knife          is_kind_of	item)
(board          is_kind_of	item)
(window         is_kind_of	item)
(light          is_kind_of	item)
(cellphone      is_kind_of	item)
(detergent      is_kind_of	item)
(answer         is_kind_of	item)
(dinner         is_kind_of	item)
(architecture   is_kind_of	item)
(beer           is_kind_of	item)
(pack           is_kind_of	item)
(juice          is_kind_of	item)
(tissue         is_kind_of	item)
(horn           is_kind_of	item)
(status         is_kind_of	item)
(handle         is_kind_of	item)
(computer       is_kind_of	item)
(mustard        is_kind_of	item)
(kettle         is_kind_of	item)
(hand           is_kind_of	item)
(bit            is_kind_of	item)
(bread          is_kind_of	item)
(pot            is_kind_of	item)
(wine           is_kind_of	item)
(soap           is_kind_of	item)
(message        is_kind_of	item)
(can            is_kind_of	item)
(apple          is_kind_of	item)
(fruit          is_kind_of	item)
(orange         is_kind_of	item)
(t_shirt        is_kind_of	item)
(salt           is_kind_of	item)
(drink          is_kind_of	item)
(cookie         is_kind_of	item)
(bench          is_kind_of	item)
(ring           is_kind_of	item)
(wifi           is_kind_of	item)
(thermostat     is_kind_of	item)
(router         is_kind_of	item)
(corn           is_kind_of	item)
(yogurt         is_kind_of	item)
(plant          is_kind_of	item)
(cell           is_kind_of	item)
(plastic        is_kind_of	item)
(pasta          is_kind_of	item)
(reading        is_kind_of	item)
(cloth          is_kind_of	item)
(horse          is_kind_of	item)
(pen            is_kind_of	item)
(bag            is_kind_of	item)
(jam            is_kind_of	item)
(remote         is_kind_of	item)
(roll           is_kind_of	item)
(mayo           is_kind_of	item)
(toilet_paper           is_kind_of	item)
(cornflakes_box	is_kind_of	item)
(cereal_box	is_kind_of	item)

#(milk 			is_kind_of 		item)
#(coke 			is_kind_of 		item)
#(orange_juice 			is_kind_of 		item)
#(beer 			is_kind_of 		item)
#(fruit 			is_kind_of 		item)
#(apple 			is_kind_of 		item)
#(banana 			is_kind_of 		item)
#(orange 			is_kind_of 		item)
#(pear 			is_kind_of 		item)
#(snacks 			is_kind_of 		item)
#(lays 			is_kind_of 		item)
#(crackers 			is_kind_of 		item)
#(pringles 			is_kind_of 		item)
#(chocolate 			is_kind_of 		item)
#(cleaning_stuff 			is_kind_of 		item)
#(cloth 			is_kind_of 		item)
#(detergent 			is_kind_of 		item)
#(sponge 			is_kind_of 		item)
#(brush 			is_kind_of 		item)

# bebidas
(drink 			is_kind_of  	item)
#(coffe 			is_kind_of 		drink)
#(water 			is_kind_of 		drink)
#(milk 			is_kind_of 		drink)
#(beer 			is_kind_of 		drink)
#(coke 			is_kind_of 		drink)
#(juice 			is_kind_of 		drink)


(question 		is_kind_of 		stuff)
(a_question 	is_kind_of 		question)
(your_name 		is_kind_of 		question)
(your_team_name 	is_kind_of 		question)
(introduce_yourself 	is_kind_of 		question)
