A	AH
A(2)	EY
BEER	B IH R
CHIPS	CH IH P S
I	AY
IS	IH Z
JUSTINA	Y UW S T IY N AH
NO	N OW
ORDER	AO R D ER
PASTA	P AA S T AH
PRINGLES	P R IH N G AH L Z
ROBOT	R OW B AA T
ROBOT(2)	R OW B AH T
START	S T AA R T
TAKE	T EY K
THE	DH AH
THE(2)	DH IY
THIS	DH IH S
WAIT	W EY T
WANT	W AA N T
WANT(2)	W AO N T
YES	Y EH S
